10
10
(7,8)
(0,3)
o..o.o..o.
..oo......
.....o....
..o.......
...o...o..
o..o..oo..
.oo...o...
.o........
.o..o..o..
....o.....